#########################################################################################
%                                           #                                           #
#   #####################################   #   #####################################   #
#   #                                   #   #   #                                   #   #
#   #   #############################   #   #   #   #############################   #   #
#   #   #                           #   #   #   #   #                           #   #   #
#   #   #   #####################   #   #   #   #   #   #####################   #   #   #
#   #   #   #                   #   #   #   #   #   #   #                   #   #   #   #
#   #   #   #   #############   #   #   #   #   #   #   #   #############   #   #   #   #
#   #   #   #   #           #   #   #   #   #   #   #   #   #           #   #   #   #   #
#   #   #   #   #           #   #   #   #   #   #   #   #   #           #   #   #   #   #
#   #   #   #   #           #   #   #   #   #   #   #   #   #           #   #   #   #   #
#   #   #   #   #           #   #   #   #   #   #   #   #   #           #   #   #   #   #
#   #   #   #   #############   #   #   #   #   #   #   #   #############   #   #   #   #
#   #   #   #                   #   #   #   #   #   #   #                   #   #   #   #
#   #   #   #####################   #   #   #   #   #   #####################   #   #   #
#   #   #                           #   #   #   #   #                           #   #   #
#   #   #############################   #   #   #   #############################   #   #
#   #                                   #   #   #                                   #   #
#   #####################################   #   #####################################   #
#                                           #                                           #
#########################################################################################