#########################################################################################
%                                           #                                           #
#   ############   ######################   #   #####################################    
#   #          #                        #   #   #                                   #   #
#   #   #############################   #   #   #   #############################   #   #
#   #   #                 #         #   #   #       #                           #   #   #
#   #   #   #####################   #   #####   #####   #####   #############   #   #   #
#   #   #                 #         #       #   #   #   #         #         #####   #   #
#   #   #   #   ###   #######   #   #   #   #   #   #   #   #########   #   #   #   #####
#   #   #   #######   #     #   #   #   #   #   #   #   #           #   #   #       #   #
#   #       #               #   #   #   #   #####   #   #   #           #   #   #####   #
#   #   #   #   #######     #   #   #   #   #   #   #################   #   #   #   #   #
#   #   #   #   #           #   #   #   #   #   #       #               #   #   #   #   #
#   #   #   #   #############   #   #   #   #   #   #   #   #############       #   #   #
#   #   #   #                   #       #   #   #   #   #           #       #   #   #   #
#   #   #   #####################   #   #   #   #   #   #########   #########   #   #   #
#   #   #                    #      #   #   #   #   #                     #     #       #
#   #   #############################   #####   #   #############################   #   #
#   #                                       #   #                                   #####
#   #####################################   #   ###########   ################   ####   #
#                                                                           #           #
#########################################################################################