#####################################################################################
%                                           #                                       #
#   #########   #########################   #   #############################   #    
#   #                                   #   #   #                       #       #   #
#   #   #############################   #   #   #   #########################   #   #
#   #                       #       #   #   #   #   #       #               #####   #
#   #   #   #####################   #####   #   #   #   #   #############   #   #####
#   #   #   #                   #   #   #   #   #   #   #               #   #   #   #
#   #   #   #   #############   $   #   #   #   #   #   #   #########   #   #   #   #
#   #   #   #   #           #   #   #   #   #   #   #   #   #       #       #   #   #
#   #####   #   #   #####   #   #   #   #   #   #   #   #   #   #   #   #       #   #
#   #   #   #   #   #   #   #   #   #   #   #       #   #   #   #####   #####       #
#   #   #   #   #####   #   #   #   #   #   #   #   #   #       #       #   #   #   #
#   #   #   #   #       #   #   #   #   #   #   #   #   #############   #   #   #   #
#   #   #       #               #   #   #   #   #               #       #   #   #   #
#   #   #   #####################   #   #####   #############   #########   #   #   #
#       #       #                   #   #   #                        #          #   #
#   #   #########     ###############   #   #################################   #   #
#   #       #                           #                    #                  #   #
#   #################################   #   #####################################   #
#                           #                                                       #
#####################################################################################

0.1 
#####################################################################################
%                                           #                                       #
#   #########   #########################   #   #############################   #    
#   #                                   #   #   #                       #       #   #
#   #   #############################   #   #   #   #########################   #   #
#   #                       #       #   #   #   #   #       #               #####   #
#   #   #   #####################   #####   #   #   #   #   #############   #   #####
#   #   #   #                           #   #   #   #   #               #   #   #   #
#   #   #   #   #############    ####   #   #   #   #   #   #########   #   #   #   #
#   #   #   #   #           #   #####   #   #   #   #   #   #       #       #   #   #
#   #####   #   #   #####   #   #   #   #   #   #   #   #   #   #   #   #       #   #
#   #   #   #   #   #   #   #   #   #   #   #       #   #   #   #####   #####       #
#   #   #   #   #####   #   #   #       #   #   #   #   #       #       #   #   #   #
#   #   #   #   #       #   #   #   #####   #   #   #   #############   #   #   #   #
#   #   #       #               #   #   #   #   #               #       #   #   #   #
#   #   #   #####################   #   #####   #############   #########   #   #   #
#       #       #                   #   #   #                        #          #   #
#   #   #########     ###############   #   #################################   #   #
#   #       #                           #                    #                  #   #
#   #################################   #   #####################################   #
#                           #                                                       #
#####################################################################################