#########################################################################################
%                                       #   #       #                                    
#   ###########   #######################   #   #####################################   #
#   #     #                   #             #   #                   #               #   #
#   #   #########   #################   #   #   #   #################   #########   #   #
#   #   #                           #   #   #   #   #               #           #   #   #
#   #   #   #####################   #   #   #   #   #   #########   #########   #   #   #
#   #   #   #                   $   #   #   #   #   #   #                   #   #   #   #
#   #   #####   #   ##########  #   #   #   #   #       #   #############   #   #   #   #
#   #   #   #####         #  #  #   #   #   #   #   #   #          #    #   #   #   #   #
#   #   #   #   #   ####  #  #  #   #   #   #   #   #   #   #####       #####   #   #   #
#       #   #   #   #  ####  ########   #   #   #   #####   #   #########       #   #   #
#   #   #       #               #   #   #   #   #   #   #   #               #   #   #   #
#   #   #   #   #############   #   #   #   #   #   #   #   #############   #   #   #   #
#   #   #   #                   #   #   #   #   #   #                       #   #   #   #
#   #####   #####################   #   #   #   #   #   #####################   #   #   #
#   #   #                           #   #   #   #   #   #                       #   #   #
#   #   #############   #############   #   #   #   ###################   #######   #   #
#   #               #                   #   #   #           #             #             #
#   #####   #############################   #   ########    #########################   #
#       #                                                                           #   #
#########################################################################################