#########################################################################################
%                                           #                                #           
#   #####################################   #   #######   ###########################   #
#   #                                   #   #   #     #                             #   #
#   #   #############################   #   #   #   #############################   #   #
#   #   #                           #   #   #       #          #                #   #   #
#   #   #   #######   ###########       #   #   #   #   #####################       #   #
#   #   #   #                   #   #   #   #   #   #   #        #          #   #   #   #
#   #   #   #   #   #########   #   #   #   #   #####       ##   ########   #   #####   #
#       #####   #       #       #   #   #   #   #       #####     ###   #   #   #   #   #
#   #   #       #       #   #####   #   #   #   #   #####   #       #   #   #   #   #   #
#   #   #   #####   #####   #   #   #   #   #   #   #   #   #####   #       #   #   #   #
#   #   #   #   #   #       #   #   #   #####   #   #   #           #   #   #   #   #   #
#   #   #   #   #####   #####   #########   #   #   #   #   #############   #   #   #   #
#   #   #   #                   #   #   #   #   #   #   #                   #   #   #   #
#   #####   #   #################   #   #   #   #   #   #######   ###########   #   #   #
#   #   #   #                       #   #   #   #   #                           #   #   #
#   #   #####################   #####   #   #   #   #############################   #   #
#   #                                   #   #   #                                   #   #
#   #####   #############################   #   #####   #############################   #
#       #                                           #                                   #
#########################################################################################