#####################################################################################
%                            #              #                                   #   #
#   ##################   ############   #   #   #################################    
#   #                           #       #   #   #               #               #   #
#   #   #   #########################   #   #   #   #############   #########   #   #
#   #   #                           #   #   #       #                       #   #   #
#   #   #   ###########   #######   #   #   #   #   #   #   #############   #   #   #
#   #   #   #                   #   #   #   #   #   #####               #####   #   #
#   #   #   #   #############   #   #   #   #   #   #   #   #####   #   #   #   #   #
#   #   #   #   #               #   #   #   #   #   #   #   #   #   #   #   #   #   #
#   #   #   #####   #########   #   #   #   #   #       #####       #   #   #   #   #
#   #   #   #       #       #   #   #   #   #   #   #   #   ####   ##   #   #   #   #
#   #   #   #   #   #   #   #####   #   #   #   #   #   #   #       #   #   #   #   #
#   #   #####   #   #####   #   #   #   #   #   #   #   #   ##   ####   #   #   #   #
#   #   #   #   #           #   #   #   #   #   #   #   #                   #   #   #
#   #   #   #   #############   #####   #   #   #   #   #################   #   #   #
#   #   #   #                       #   #   #   #   #                       #   #   #
#   #   #####################   #####   #   #   #   #########################   #   #
#   #                       #           #   #   #          #                    #   #
#   ##################   ################   #   ############   ##################   #
#                                                        #                          #
#####################################################################################